{
  "name": "Night Shift",
  "number": 0,
  "layout": [
    [1, 2, 1, 1, 1, 6, 1, 1, 1, 1, 1, 1, 1],
    [1, 0, 1, 0, 0, 0, 0, 0, 0, 0, 0, 0, 1],
    [1, 2, 1, 0, 0, 0, 0, 0, 0, 0, 0, 0, 1],
    [1, 0, 0, 0, 1, 5, 5, 5, 1, 5, 1, 0, 1],
    [1, 2, 2, 1, 1, 8, 8, 0, 1, 0, 1, 0, 1],
    [1, 0, 0, 0, 1, 8, 8, 0, 1, 0, 1, 0, 1],
    [1, 0, 0, 0, 8, 8, 8, 0, 1, 0, 1, 0, 1],
    [1, 8, 8, 8, 1, 1, 1, 0, 1, 0, 1, 0, 1],
    [1, 8, 8, 8, 1, 0, 1, 0, 1, 0, 1, 0, 1],
    [1, 8, 8, 8, 1, 0, 1, 0, 1, 0, 3, 0, 1],
    [1, 0, 0, 0, 1, 2, 1, 0, 1, 1, 1, 0, 1],
    [1, 0, 0, 0, 0, 0, 0, 0, 8, 8, 8, 0, 1],
    [1, 1, 1, 1, 1, 1, 1, 1, 1, 1, 1, 1, 1]
  ],
  "spawn_player": 
    [1, 1],
  "spawn_enemies":
  [
    [1, 9, 2],
    [11, 2, 2],
    [5, 9, 2],
    [8, 5, 2],
    [4, 7, 1],
    [6, 1, 3],
    [9, 1, 3],
    [8, 2, 3],
    [11, 1, 3],
    [5, 7, 1]
  ],
  "spawn_items":
  [
    [1, 3, 3, -1],
    [5, 3, 3, -1],
    [2, 6, 2, 3],
    [11, 5, 2, 3],
    [8, 5, 5, -1]
  ],
  "exit":
    [0, 5]
}

