{
  "name": "Night Shift",
  "number": 0,
  "layout": [
    [9, 9, 1, 8, 1, 9, 9, 9, 9, 9, 9],
    [9, 1, 1, 2, 1, 1, 5, 1, 5, 1, 1],
    [9, 1, 0, 0, 0, 0, 0, 0, 0, 0, 4],
    [9, 1, 2, 1, 5, 1, 5, 1, 1, 0, 1],
    [9, 1, 0, 1, 0, 4, 0, 0, 1, 0, 4],
    [9, 1, 0, 1, 0, 1, 0, 0, 4, 0, 1],
    [9, 1, 0, 4, 0, 0, 0, 0, 1, 0, 4],
    [1, 1, 0, 1, 0, 0, 0, 0, 1, 0, 1],
    [7, 0, 0, 1, 0, 0, 0, 0, 0, 0, 4],
    [1, 1, 1, 1, 1, 1, 1, 1, 1, 1, 1]
  ],
  "spawn_player": 
    [0, 3],
  "spawn_enemies":
  [
    [4, 4, 2],
    [4, 6, 2],
    [6, 2, 2],
    [8, 4, 1]
  ],
  "spawn_items":
  [
    [8, 9, 2, 4],
    [5, 2, 2, 4],
    [8, 2, 5, -1]
  ],
  "exit":
    [8, 0]
}

