{
  "name": "Night Shift",
  "number": 0,
  "layout": [
    [1, 1, 1, 1, 1, 1, 1, 1, 1, 1, 1, 1, 1],
    [1, 0, 1, 0, 0, 8, 8, 8, 0, 0, 0, 0, 1],
    [1, 2, 1, 0, 0, 8, 8, 8, 0, 0, 0, 0, 1],
    [1, 0, 1, 0, 0, 8, 8, 8, 0, 0, 0, 0, 1],
    [1, 0, 1, 1, 2, 1, 1, 1, 1, 1, 1, 2, 1],
    [1, 0, 4, 0, 0, 1, 0, 0, 0, 0, 3, 0, 1],
    [1, 0, 1, 0, 0, 1, 0, 0, 0, 0, 1, 0, 1],
    [1, 8, 4, 0, 0, 1, 0, 0, 0, 0, 1, 6, 1],
    [1, 8, 1, 0, 0, 1, 0, 0, 0, 0, 1, 9, 9],
    [1, 8, 3, 0, 0, 1, 0, 0, 0, 0, 4, 9, 9],
    [1, 0, 1, 0, 0, 1, 0, 8, 8, 8, 1, 9, 9],
    [1, 0, 1, 0, 0, 1, 0, 8, 8, 8, 4, 9, 9],
    [1, 1, 1, 5, 5, 1, 1, 5, 1, 5, 1, 9, 9]
  ],
  "spawn_player": 
    [1, 1],
  "spawn_enemies":
  [
    [8, 1, 3],
    [5, 3, 2],
    [2, 9, 2],
    [8, 3, 3],
    [9, 6, 3],
    [11, 9, 2]
  ],
  "spawn_items":
  [
    [3, 1, 3, -1],
    [6, 9, 2, 3],
    [11, 7, 5, -1]
  ],
  "exit":
    [7, 11]
}

