{
  "name": "Night Shift",
  "number": 0,
  "layout": [
    [9, 9, 9, 9, 9, 9, 9, 9, 9, 9, 9],
    [9, 1, 5, 1, 5, 1, 5, 1, 5, 1, 1],
    [9, 1, 0, 0, 0, 0, 0, 0, 0, 0, 4],
    [9, 1, 2, 1, 1, 1, 1, 1, 1, 0, 1],
    [9, 1, 0, 1, 9, 9, 9, 9, 1, 0, 1],
    [9, 1, 0, 1, 9, 9, 9, 9, 1, 0, 1],
    [9, 1, 0, 1, 9, 9, 9, 9, 1, 0, 1],
    [9, 1, 0, 1, 1, 1, 1, 9, 1, 6, 1],
    [8, 3, 0, 3, 0, 0, 1, 9, 9, 9, 9],
    [9, 1, 1, 1, 1, 1, 1, 9, 9, 9, 9]
  ],
  "spawn_player": 
    [8, 0],
  "spawn_enemies":
  [
    [4, 2, 1],
    [2, 8, 1]
  ],
  "spawn_items":
  [
    [8, 5, 2, 2],
    [5, 9, 5, -1]
  ],
  "exit":
    [7, 9]
}

