{
  "name": "Night Shift",
  "number": 0,
  "layout": [
    [1, 1, 1, 1, 1, 1, 1, 1, 1, 1, 1, 9, 9],
    [1, 0, 3, 0, 3, 0, 0, 0, 1, 0, 1, 9, 9],
    [1, 0, 1, 0, 1, 0, 0, 0, 3, 0, 3, 8, 9],
    [1, 2, 1, 0, 1, 1, 5, 1, 1, 0, 1, 9, 9],
    [1, 0, 0, 0, 0, 0, 0, 0, 1, 0, 1, 1, 1],
    [1, 0, 0, 0, 0, 0, 0, 0, 1, 0, 0, 0, 1],
    [1, 0, 1, 1, 1, 1, 2, 1, 1, 1, 2, 1, 1],
    [1, 0, 0, 0, 0, 1, 0, 1, 0, 0, 0, 7, 9],
    [1, 0, 0, 0, 0, 3, 0, 3, 0, 1, 5, 1, 1],
    [1, 0, 0, 0, 0, 3, 0, 3, 0, 0, 0, 0, 1],
    [1, 1, 1, 0, 0, 1, 0, 1, 0, 0, 0, 0, 1],
    [1, 0, 3, 0, 0, 0, 0, 0, 0, 0, 0, 0, 1],
    [1, 1, 1, 1, 1, 1, 1, 1, 1, 1, 1, 1, 1]
  ],
  "spawn_player":
    [2, 11],
  "spawn_enemies":
  [
    [10, 10, 1],
    [5, 6, 2],
    [11, 11, 2],
    [1, 3, 2],
    [9, 3, 1],
    [9, 11, 3],
    [4, 1, 3],
    [1, 6, 3],
    [9, 1, 3],
    [8, 3, 2],
    [8, 2, 2],
    [5, 3, 1]
  ],
  "spawn_items":
  [
    [5, 11, 3, -1],
    [7, 6, 2, 3],
    [1, 9, 2, 2],
    [1, 1, 2, 2],
    [5, 7, 4, 1],
    [11, 1, 5, -1]
  ],
  "exit":
    [7, 11]
}

