{
  "name": "The Afterparty",
  "number": 0,
  "layout": [
    [9, 9, 9, 9, 9, 1, 1, 1, 1, 1, 1, 1, 1, 1, 1, 1, 1, 1, 1],
    [1, 1, 1, 1, 1, 1, 0, 1, 0, 0, 0, 0, 0, 0, 0, 0, 0, 0, 1],
    [1, 0, 0, 0, 0, 3, 0, 3, 0, 0, 0, 0, 0, 0, 0, 0, 0, 0, 1],
    [1, 1, 0, 1, 0, 1, 0, 1, 2, 1, 1, 1, 0, 0, 0, 0, 0, 0, 1],
    [1, 0, 0, 0, 0, 3, 0, 3, 0, 0, 0, 1, 1, 1, 5, 5, 1, 1, 1],
    [1, 2, 1, 2, 1, 1, 5, 1, 0, 1, 0, 0, 0, 0, 0, 0, 7, 0, 1],
    [1, 0, 4, 0, 1, 1, 0, 1, 0, 3, 0, 8, 8, 8, 0, 0, 1, 1, 1],
    [1, 0, 4, 0, 1, 0, 0, 1, 0, 1, 0, 8, 8, 8, 0, 0, 7, 0, 1],
    [1, 0, 4, 0, 1, 0, 1, 1, 0, 1, 0, 8, 8, 8, 0, 0, 1, 1, 1],
    [1, 0, 4, 0, 1, 0, 1, 0, 0, 3, 0, 0, 0, 0, 0, 0, 7, 0, 1],
    [1, 0, 4, 0, 1, 0, 1, 0, 0, 1, 1, 1, 1, 1, 1, 1, 1, 1, 1],
    [1, 2, 1, 2, 1, 0, 1, 0, 0, 0, 0, 8, 8, 8, 8, 0, 0, 0, 1],
    [1, 0, 0, 0, 7, 0, 3, 0, 0, 0, 0, 8, 8, 8, 8, 0, 0, 0, 1],
    [1, 0, 0, 0, 1, 0, 1, 0, 0, 0, 0, 8, 8, 8, 8, 0, 0, 0, 1],
    [1, 1, 1, 1, 1, 0, 1, 1, 1, 1, 1, 1, 1, 1, 1, 1, 1, 1, 1],
    [1, 0, 0, 0, 1, 0, 1, 0, 0, 0, 3, 0, 0, 0, 0, 0, 0, 0, 7],
    [1, 0, 0, 0, 3, 0, 7, 0, 0, 0, 1, 2, 1, 1, 1, 1, 1, 1, 1],
    [1, 0, 0, 0, 1, 0, 1, 0, 0, 0, 3, 0, 0, 0, 0, 0, 0, 0, 1],
    [1, 1, 1, 1, 1, 2, 1, 1, 1, 1, 1, 1, 1, 1, 1, 1, 1, 1, 1]
  ],
  "spawn_player":
    [18, 5],
  "spawn_enemies":
  [
    [15, 1, 3],
    [15, 14, 3],
    [7, 1, 3],
    [3, 15, 2],
    [16, 8, 2],
    [1, 14, 3],
    [1, 13, 3],
    [12, 17, 1],
    [17, 17, 1],
    [12, 16, 1],
    [7, 3, 1],
    [17, 1, 3]
  ],
  "spawn_items":
  [
    [9, 17, 4, 1],
    [7, 17, 3, -1],
    [17, 11, 3, -1],
    [4, 3, 3, -1],
    [10, 3, 3, -1],
    [5, 17, 2, 3],
    [4, 1, 2, 1],
    [10, 1, 2, 1],
    [15, 17, 2, 1],
    [16, 3, 2, 3],
    [12, 8, 1, 3],
    [13, 1, 1, 2],
    [7, 11, 5, -1],
    [2, 17, 5, -1],
    [12, 3, 5, -1],
    [17, 17, 5, -1],
    [16, 1, 5, -1]
  ],
  "exit":
    [15, 18]
}