{
  "name": "The Afterparty",
  "number": 0,
  "layout": [
    [9, 9, 9, 9, 9, 9, 1, 1, 1, 1, 1, 1, 1, 1, 1, 1],
    [9, 9, 1, 2, 1, 1, 1, 0, 0, 0, 0, 1, 0, 0, 0, 1],
    [1, 1, 1, 0, 1, 0, 0, 0, 0, 0, 0, 3, 0, 0, 0, 1],
    [1, 0, 0, 0, 1, 0, 1, 0, 0, 0, 0, 3, 0, 0, 0, 1],
    [1, 0, 0, 0, 1, 6, 1, 0, 0, 0, 0, 1, 0, 0, 0, 1],
    [1, 0, 1, 0, 0, 0, 1, 1, 1, 1, 1, 1, 1, 1, 1, 1],
    [1, 0, 1, 0, 0, 0, 1, 0, 0, 0, 0, 0, 0, 0, 0, 1],
    [1, 0, 1, 0, 0, 0, 1, 0, 0, 8, 8, 8, 8, 0, 0, 1],
    [1, 0, 1, 0, 0, 0, 7, 0, 0, 8, 8, 8, 8, 0, 0, 7],
    [1, 0, 1, 0, 0, 0, 1, 0, 0, 8, 8, 8, 8, 0, 0, 1],
    [1, 0, 1, 0, 0, 0, 1, 0, 0, 0, 0, 0, 0, 0, 0, 1],
    [1, 0, 1, 1, 1, 2, 1, 1, 1, 1, 1, 1, 1, 1, 1, 1],
    [1, 0, 0, 0, 0, 0, 1, 0, 0, 1, 0, 0, 0, 0, 0, 1],
    [1, 0, 0, 0, 0, 0, 7, 0, 0, 3, 0, 0, 0, 0, 0, 1],
    [1, 1, 0, 0, 0, 0, 1, 0, 0, 1, 0, 0, 0, 0, 0, 1],
    [9, 1, 1, 1, 1, 1, 1, 1, 1, 1, 1, 1, 1, 1, 1, 1]
  ],
  "spawn_player":
    [1, 3],
  "spawn_enemies":
  [
    [4, 14, 1],
    [1, 14, 1],
    [14, 2, 3],
    [12, 2, 3],
    [14, 14, 3],
    [12, 14, 3],
    [4, 10, 3],
    [1, 10, 3],
    [13, 11, 2],
    [8, 8, 2],
    [8, 11, 2],
    [10, 14, 2],
    [6, 14, 2],
    [8, 13, 2]
  ],
  "spawn_items":
  [
    [6, 3, 4, 1],
    [3, 5, 3, -1],
    [14, 5, 3, -1],
    [12, 8, 4, 1],
    [14, 8, 2, 3],
    [8, 8, 3, -1],
    [4, 12, 5, -1],
    [13, 14, 5, -1],
    [7, 3, 5, -1],
    [8, 14, 5, -1]
  ],
  "exit":
    [8, 15]
}

