{
  "name": "The Afterparty",
  "number": 0,
  "layout": [
    [1, 1, 1, 1, 1, 1, 1, 1, 1, 1, 1, 1, 1, 1, 1, 1, 1, 1, 1],
    [1, 0, 0, 0, 1, 0, 0, 0, 1, 0, 1, 0, 0, 0, 1, 0, 0, 0, 1],
    [1, 0, 0, 0, 0, 0, 0, 0, 0, 0, 0, 0, 0, 0, 0, 0, 0, 0, 1],
    [1, 0, 0, 0, 1, 0, 0, 0, 1, 0, 1, 0, 0, 0, 1, 0, 0, 0, 1],
    [1, 1, 0, 1, 1, 5, 5, 5, 1, 2, 1, 5, 5, 5, 1, 1, 0, 1, 1],
    [1, 0, 0, 0, 4, 0, 0, 0, 0, 0, 0, 0, 0, 0, 4, 0, 0, 0, 1],
    [1, 0, 0, 0, 4, 0, 0, 0, 0, 0, 0, 0, 0, 0, 4, 0, 0, 0, 1],
    [1, 0, 0, 0, 4, 0, 0, 0, 0, 0, 0, 0, 0, 0, 4, 0, 0, 0, 1],
    [1, 1, 0, 1, 1, 0, 0, 0, 1, 6, 1, 0, 0, 0, 1, 1, 0, 1, 1],
    [1, 0, 0, 0, 3, 0, 0, 0, 1, 0, 1, 0, 0, 0, 3, 0, 0, 0, 1],
    [1, 1, 0, 1, 1, 0, 0, 0, 1, 2, 1, 0, 0, 0, 1, 1, 0, 1, 1],
    [1, 0, 0, 0, 4, 0, 0, 0, 0, 0, 0, 0, 0, 0, 4, 0, 0, 0, 1],
    [1, 0, 0, 0, 4, 0, 0, 0, 0, 0, 0, 0, 0, 0, 4, 0, 0, 0, 1],
    [1, 0, 0, 0, 4, 0, 0, 0, 0, 0, 0, 0, 0, 0, 4, 0, 0, 0, 1],
    [1, 1, 0, 1, 1, 5, 5, 5, 1, 2, 1, 5, 5, 5, 1, 1, 0, 1, 1],
    [1, 0, 0, 0, 1, 0, 0, 0, 1, 0, 1, 0, 0, 0, 1, 0, 0, 0, 1],
    [1, 0, 0, 0, 0, 0, 0, 0, 0, 0, 0, 0, 0, 0, 0, 0, 0, 0, 1],
    [1, 0, 0, 0, 1, 0, 0, 0, 1, 0, 1, 0, 0, 0, 1, 0, 0, 0, 1],
    [1, 1, 1, 1, 1, 1, 1, 1, 1, 1, 1, 1, 1, 1, 1, 1, 1, 1, 1]
  ],
  "spawn_player":
    [9, 9],
  "spawn_enemies":
  [
    [16, 2, 1],
    [16, 6, 1],
    [16, 12, 1],
    [16, 16, 1],
    [12, 2, 1],
    [12, 16, 1],
    [6, 16, 1],
    [2, 16, 1],
    [2, 6, 1],
    [2, 12, 1],
    [6, 2, 1],
    [2, 2, 1]
  ],
  "spawn_items":
  [
    [13, 9, 3, -1],
    [11, 8, 1, 3],
    [11, 10, 1, 3]
  ],
  "exit":
    [8, 9]
}