{
  "name": "The Afterparty",
  "number": 3,
  "layout": [
    [0, 0, 0, 0, 1, 5, 5, 5, 5, 5, 5, 5, 5, 5, 1, 0, 0, 0, 0],
    [0, 8, 8, 8, 1, 8, 8, 8, 8, 8, 8, 8, 8, 8, 1, 8, 8, 8, 0],
    [0, 8, 8, 8, 3, 8, 8, 8, 8, 8, 8, 8, 8, 8, 8, 8, 8, 8, 0],
    [0, 8, 8, 8, 1, 8, 8, 8, 8, 8, 8, 8, 8, 8, 1, 8, 8, 8, 0],
    [0, 8, 8, 8, 1, 5, 5, 5, 5, 5, 5, 5, 5, 5, 1, 8, 8, 8, 0],
    [0, 8, 8, 8, 4, 0, 0, 0, 0, 0, 0, 0, 0, 0, 4, 8, 8, 8, 0],
    [0, 8, 8, 8, 4, 0, 0, 0, 0, 0, 0, 0, 0, 0, 4, 8, 8, 8, 0],
    [0, 8, 8, 8, 1, 0, 0, 0, 0, 0, 0, 0, 0, 0, 4, 8, 8, 8, 0],
    [0, 8, 8, 8, 3, 0, 0, 0, 0, 0, 0, 0, 0, 0, 4, 8, 8, 8, 0],
    [0, 8, 8, 8, 3, 0, 0, 0, 0, 0, 0, 0, 0, 0, 4, 8, 8, 8, 0],
    [0, 8, 8, 8, 3, 0, 0, 0, 0, 0, 0, 0, 0, 0, 4, 8, 8, 8, 0],
    [0, 8, 8, 8, 1, 0, 0, 0, 0, 0, 0, 0, 0, 0, 4, 8, 8, 8, 0],
    [0, 8, 8, 8, 4, 0, 0, 0, 0, 0, 0, 0, 0, 0, 4, 8, 8, 8, 0],
    [0, 8, 8, 8, 4, 0, 0, 0, 0, 0, 0, 0, 0, 0, 4, 8, 8, 8, 0],
    [0, 8, 8, 8, 1, 5, 5, 5, 5, 5, 5, 5, 5, 5, 1, 2, 2, 2, 1],
    [0, 8, 8, 8, 3, 8, 8, 8, 8, 8, 8, 8, 8, 8, 3, 8, 8, 8, 1],
    [0, 8, 8, 8, 3, 8, 8, 8, 8, 8, 8, 8, 8, 8, 3, 8, 8, 8, 7],
    [0, 8, 8, 8, 3, 8, 8, 8, 8, 8, 8, 8, 8, 8, 3, 8, 8, 8, 1],
    [0, 0, 0, 0, 1, 5, 5, 5, 5, 5, 5, 5, 5, 5, 1, 5, 5, 5, 1]
  ],
  "spawn_player":
    [9, 0],
  "spawn_enemies":
  [
    [12, 6, 2],
    [10, 7, 2],
    [13, 9, 2],
    [6, 7, 2],
    [10, 12, 2],
    [9, 11, 2],
    [7, 11, 2],
    [6, 6, 2],
    [9, 9, 2],
    [7, 13, 2]
  ],
  "spawn_items":
  [
    [16, 9, 4, 1],
    [9, 16, 5, -1]
  ],
  "exit":
    [16, 18]
}

