{
  "name": "The Afterparty",
  "number": 0,
  "layout": [
    [9, 9, 9, 1, 1, 1, 1, 1, 1, 1, 1, 1, 1],
    [9, 9, 9, 1, 0, 0, 0, 0, 0, 0, 0, 0, 1],
    [1, 1, 1, 1, 1, 0, 1, 1, 1, 1, 5, 5, 1],
    [1, 0, 0, 3, 0, 0, 0, 0, 0, 0, 0, 0, 0],
    [1, 0, 0, 1, 0, 1, 1, 1, 5, 5, 5, 5, 1],
    [1, 1, 1, 1, 0, 1, 0, 1, 0, 0, 0, 0, 1],
    [1, 0, 0, 4, 0, 4, 0, 4, 0, 0, 1, 1, 1],
    [1, 0, 0, 1, 0, 1, 0, 1, 0, 0, 1, 9, 9],
    [1, 0, 0, 1, 0, 3, 0, 0, 0, 0, 1, 1, 1],
    [1, 0, 1, 1, 0, 1, 0, 0, 1, 0, 0, 0, 1],
    [1, 0, 0, 0, 0, 1, 0, 0, 1, 0, 1, 1, 1],
    [1, 0, 0, 1, 0, 1, 0, 0, 1, 0, 1, 9, 9],
    [1, 1, 1, 1, 2, 1, 1, 1, 1, 1, 1, 9, 9]
  ],
  "spawn_player":
    [12, 4],
  "spawn_enemies":
  [
    [4, 2, 3],
    [3, 2, 3],
    [6, 2, 2],
    [11, 6, 2],
    [1, 11, 2],
    [3, 9, 2],
    [5, 11, 1]
  ],
  "spawn_items":
  [
    [10, 4, 4, 1],
    [5, 6, 2, 4],
    [8, 8, 3, -1],
    [1, 11, 5, -1]
  ],
  "exit":
    [7, 11]
}

