
{
  "name": "Carte Blanche",
  "number": 1,
  "layout": [
    [1, 5, 5, 5, 5, 5, 5, 5, 1, 1, 1, 5, 5, 5, 5, 5, 5, 5, 1],
    [4, 0, 0, 0, 0, 0, 0, 0, 1, 6, 1, 0, 0, 0, 0, 0, 0, 0, 4],
    [4, 0, 0, 0, 0, 0, 0, 0, 0, 0, 0, 0, 0, 0, 0, 0, 0, 0, 4],
    [4, 0, 0, 0, 0, 0, 0, 0, 0, 0, 0, 0, 0, 0, 0, 0, 0, 0, 4],
    [4, 0, 0, 0, 0, 0, 0, 0, 0, 0, 0, 0, 0, 0, 0, 0, 0, 0, 4],
    [4, 0, 0, 1, 1, 1, 1, 1, 1, 0, 1, 1, 1, 1, 1, 1, 0, 0, 4],
    [4, 0, 0, 1, 0, 0, 0, 0, 3, 0, 3, 0, 0, 0, 0, 1, 0, 0, 4],
    [4, 0, 0, 1, 0, 1, 1, 1, 1, 0, 1, 1, 1, 1, 0, 1, 0, 0, 4],
    [4, 0, 0, 3, 0, 1, 0, 0, 0, 0, 0, 0, 0, 1, 0, 3, 0, 0, 4],
    [4, 0, 0, 1, 1, 1, 2, 1, 1, 0, 1, 1, 2, 1, 1, 1, 0, 0, 4],
    [4, 0, 0, 1, 0, 0, 0, 1, 0, 0, 0, 1, 0, 0, 0, 1, 0, 0, 4],
    [4, 0, 0, 1, 0, 0, 0, 1, 0, 0, 0, 1, 0, 0, 0, 1, 0, 0, 4],
    [4, 0, 0, 1, 1, 1, 1, 1, 5, 5, 5, 1, 1, 1, 1, 1, 0, 0, 4],
    [4, 0, 0, 3, 0, 0, 4, 0, 0, 0, 0, 0, 3, 0, 0, 0, 0, 0, 4],
    [4, 0, 0, 1, 1, 1, 1, 0, 0, 0, 0, 0, 1, 1, 1, 1, 0, 0, 4],
    [4, 0, 0, 4, 0, 0, 0, 0, 0, 0, 0, 0, 0, 0, 0, 4, 0, 0, 4],
    [4, 0, 0, 4, 0, 0, 0, 0, 1, 2, 1, 0, 0, 0, 0, 4, 0, 0, 4],
    [4, 0, 0, 4, 0, 0, 0, 0, 3, 0, 3, 0, 0, 0, 0, 4, 0, 0, 4],
    [1, 5, 5, 1, 5, 5, 5, 1, 1, 2, 1, 1, 5, 5, 5, 1, 5, 5, 1]
  ],
  "spawn_player":
    [18, 9],
  "spawn_enemies":
  [
    [13, 5, 1],
    [17, 16, 1],
    [1, 1, 1],
    [1, 17, 1],
    [11, 12, 1],
    [11, 4, 1],
    [17, 2, 2],
    [11, 9, 2]
  ],
  "spawn_items":
  [
    [17, 9, 2, 2],
    [8, 4, 2, 2],
    [10, 5, 2, 3],
    [10, 13, 2, 3],
    [13, 5, 5, -1],
    [17, 11, 1, 2]
  ],
  "exit":
    [1, 9]
}