
{
  "name": "Carte Blanche",
  "number": 5,
  "layout": [
    [0, 0, 0, 0, 0, 0, 0, 0, 0, 0, 0, 0, 0, 0, 0],
    [0, 0, 0, 0, 0, 0, 0, 0, 0, 0, 0, 0, 0, 0, 0],
    [0, 0, 0, 8, 0, 0, 8, 0, 0, 0, 0, 0, 0, 0, 0],
    [0, 0, 0, 8, 0, 0, 8, 0, 0, 0, 0, 0, 0, 0, 0],
    [0, 0, 0, 8, 0, 0, 8, 0, 0, 0, 0, 0, 0, 0, 0],
    [0, 0, 0, 8, 8, 8, 8, 0, 0, 0, 0, 0, 0, 0, 0],
    [0, 0, 0, 8, 0, 0, 8, 0, 0, 0, 0, 0, 0, 0, 0],
    [0, 0, 0, 8, 0, 0, 8, 0, 0, 0, 0, 1, 1, 1, 0],
    [0, 0, 0, 8, 0, 0, 8, 0, 0, 0, 0, 7, 8, 1, 0],
    [0, 0, 0, 0, 0, 0, 0, 0, 0, 0, 0, 1, 1, 1, 0],
    [0, 0, 0, 0, 0, 0, 0, 0, 0, 0, 0, 0, 0, 0, 0],
    [0, 0, 0, 0, 0, 0, 1, 2, 1, 0, 0, 0, 0, 0, 0],
    [0, 0, 0, 0, 0, 0, 1, 0, 1, 0, 0, 0, 0, 0, 0],
    [0, 0, 0, 0, 0, 0, 1, 1, 1, 0, 0, 0, 0, 0, 0],
    [0, 0, 0, 0, 0, 0, 0, 0, 0, 0, 0, 0, 0, 0, 0]
  ],
  "spawn_player":
    [12, 7],
  "spawn_enemies":
  [
    [2, 7, 1]
  ],
  "spawn_items":
  [
    [10, 8, 1, 1],
    [10, 6, 2, 3],
    [6, 11, 5, -1]
  ],
  "exit":
    [8, 11]
}