
{
  "name": "Carte Blanche",
  "number": 2,
  "layout": [
    [9, 9, 9, 1, 5, 5, 5, 5, 1, 6, 1, 5, 5, 5, 5, 1, 9, 9, 9],
    [9, 9, 1, 0, 0, 0, 0, 0, 1, 0, 1, 0, 0, 0, 0, 0, 1, 9, 9],
    [9, 1, 0, 0, 0, 0, 0, 0, 1, 0, 1, 0, 0, 0, 0, 0, 0, 1, 9],
    [1, 0, 0, 1, 0, 0, 0, 0, 3, 0, 3, 0, 0, 0, 0, 0, 0, 0, 1],
    [4, 0, 0, 0, 0, 0, 0, 0, 1, 0, 1, 0, 0, 0, 0, 0, 0, 0, 4],
    [4, 0, 0, 0, 0, 0, 0, 0, 1, 0, 1, 0, 0, 0, 0, 0, 0, 0, 4],
    [4, 0, 0, 0, 0, 1, 1, 1, 1, 0, 1, 1, 1, 1, 0, 0, 0, 0, 4],
    [4, 0, 0, 0, 0, 1, 0, 0, 0, 0, 0, 0, 0, 1, 0, 0, 0, 0, 4],
    [4, 0, 0, 0, 0, 1, 0, 0, 0, 0, 0, 0, 0, 1, 0, 0, 0, 0, 4],
    [1, 0, 0, 0, 0, 1, 0, 0, 1, 2, 1, 0, 0, 1, 1, 2, 2, 1, 1],
    [4, 0, 0, 0, 0, 0, 0, 0, 3, 0, 3, 0, 0, 0, 0, 0, 0, 0, 4],
    [1, 0, 0, 0, 0, 1, 0, 0, 1, 2, 1, 0, 0, 1, 1, 2, 2, 1, 1],
    [4, 0, 0, 0, 0, 1, 0, 0, 0, 0, 0, 0, 0, 1, 0, 0, 0, 0, 4],
    [4, 0, 0, 0, 0, 1, 0, 0, 0, 0, 0, 0, 0, 1, 0, 0, 0, 0, 4],
    [4, 0, 0, 0, 0, 1, 1, 1, 1, 0, 1, 1, 1, 1, 0, 0, 0, 0, 4],
    [1, 0, 0, 0, 0, 0, 0, 0, 1, 0, 1, 0, 0, 0, 0, 0, 0, 0, 1],
    [9, 1, 0, 0, 0, 0, 0, 0, 0, 0, 0, 0, 0, 0, 0, 0, 0, 1, 9],
    [9, 9, 1, 0, 0, 0, 0, 0, 1, 0, 1, 0, 0, 0, 0, 0, 1, 9, 9],
    [9, 9, 9, 1, 5, 5, 5, 5, 1, 5, 1, 5, 5, 5, 5, 1, 9, 9, 9]
  ],
  "spawn_player":
    [10, 9],
  "spawn_enemies":
  [
    [10, 1, 1],
    [17, 5, 1],
    [2, 16, 1],
    [3, 13, 1],
    [15, 13, 1],
    [17, 9, 1],
    [1, 9, 3],
    [17, 7, 3],
    [17, 11, 3],
    [4, 3, 3],
    [3, 2, 3],
    [2, 3, 3],
    [3, 4, 3]
  ],
  "spawn_items":
  [
    [10, 1, 3, -1],
    [8, 16, 3, -1],
    [12, 16, 1, 3],
    [10, 4, 1, 3],
    [10, 7, 4, 1],
    [12, 9, 2, 1],
    [16, 4, 2, 4],
    [8, 9, 2, 1],
    [2, 6, 5, -1]
  ],
  "exit":
    [0, 9]
}