
{
  "name": "Carte Blanche",
  "number": 3,
  "layout": [
    [1, 1, 1, 1, 1, 1, 1, 6, 1, 1, 1, 1, 1, 1, 1],
    [1, 0, 0, 0, 0, 0, 1, 0, 1, 0, 0, 0, 0, 0, 1],
    [1, 0, 0, 0, 0, 0, 1, 0, 1, 0, 0, 0, 0, 0, 1],
    [1, 0, 0, 1, 0, 0, 0, 0, 0, 0, 0, 1, 0, 0, 1],
    [1, 0, 0, 0, 0, 0, 1, 0, 1, 0, 0, 0, 0, 0, 1],
    [1, 0, 0, 0, 0, 0, 1, 0, 1, 0, 0, 0, 0, 0, 1],
    [1, 1, 1, 0, 1, 1, 1, 0, 1, 1, 1, 0, 1, 1, 1],
    [1, 0, 0, 0, 0, 0, 0, 0, 0, 0, 0, 0, 0, 0, 1],
    [1, 1, 1, 0, 1, 1, 1, 0, 1, 1, 1, 0, 1, 1, 1],
    [1, 0, 0, 0, 0, 0, 1, 0, 1, 0, 0, 0, 0, 0, 1],
    [1, 0, 0, 0, 0, 0, 1, 0, 1, 0, 0, 0, 0, 0, 1],
    [1, 0, 0, 1, 0, 0, 3, 0, 3, 0, 0, 1, 0, 0, 1],
    [1, 0, 0, 0, 0, 0, 1, 0, 1, 0, 0, 0, 0, 0, 1],
    [1, 0, 0, 0, 0, 0, 1, 0, 1, 0, 0, 0, 0, 0, 1],
    [1, 1, 1, 1, 1, 1, 1, 0, 1, 1, 1, 1, 1, 1, 1]
  ],
  "spawn_player":
    [14, 7],
  "spawn_enemies":
  [
    [3, 10, 3],
    [11, 2, 3],
    [12, 3, 3],
    [11, 4, 3],
    [10, 3, 3],
    [4, 3, 3],
    [3, 2, 3],
    [2, 3, 3],
    [3, 4, 3],
    [3, 10, 3],
    [11, 9, 2],
    [10, 12, 1]
  ],
  "spawn_items":
  [
    [7, 6, 1, 2],
    [7, 1, 1, 2],
    [6, 7, 4, 1],
    [3, 5, 2, 4],
    [7, 8, 4, 1],
    [13, 11, 5, -1]
  ],
  "exit":
    [0, 7]
}