{
  "name": "Example Level",
  "number": 0,
  "layout": [
    [1, 1, 1, 1, 1, 1, 2, 1, 1, 1],
    [1, 0, 0, 0, 0, 0, 0, 1, 0, 0],
    [1, 0, 0, 0, 0, 0, 0, 1, 0, 0],
    [1, 0, 0, 0, 0, 0, 0, 1, 0, 0],
    [1, 0, 0, 0, 0, 0, 0, 1, 0, 0],
    [1, 0, 0, 0, 0, 0, 0, 0, 0, 0],
    [1, 0, 0, 0, 0, 0, 0, 0, 0, 0],
    [1, 0, 0, 0, 0, 0, 0, 1, 0, 1],
    [2, 0, 0, 0, 0, 0, 0, 1, 0, 1],
    [1, 1, 1, 1, 1, 1, 1, 1, 2, 1]
  ],
  "spawn_player": 
    [8, 0],
  "spawn_enemies":
  [
    [4, 4, 1],
    [1, 8, 1],
    [5, 5, 1]
  ]
}

