{
  "name": "Example Level",
  "number": 0,
  "layout": [
    [1, 1, 1, 1, 1, 1, 5, 1, 1, 1, 1],
    [1, 0, 0, 0, 1, 0, 0, 1, 0, 0, 1],
    [1, 0, 0, 0, 1, 0, 0, 1, 0, 0, 4],
    [1, 0, 0, 0, 1, 0, 0, 1, 0, 0, 1],
    [1, 6, 1, 1, 1, 0, 0, 1, 0, 0, 4],
    [1, 0, 0, 0, 0, 0, 0, 0, 0, 0, 1],
    [1, 0, 0, 8, 8, 0, 0, 0, 0, 0, 4],
    [1, 0, 0, 8, 8, 0, 0, 1, 0, 0, 1],
    [3, 0, 0, 0, 0, 0, 0, 1, 0, 0, 1],
    [1, 1, 1, 1, 1, 1, 1, 1, 2, 1, 1]
  ],
  "spawn_player": 
    [8, 0],
  "spawn_enemies":
  [
    [2, 2, 1],
    [1, 8, 2]
  ],
  "spawn_items":
  [
    [8, 8, 4, 1],
    [7, 1, 2, 3],
    [1, 5, 1, 2],
    [1, 3, 5, -1],
    [1, 1, 3, -1]
  ]
}

